10111111111111111111111111111111111111111111111111
10000000000001011001000101010010101100001010110101
11011111111100001011011101010110101101100000110101
10001110101111100000000000000000001000111111100001
11100000000001101011011111101010111010010110110111
10101110101111101011000000111111110011000000000001
10101111111000111110011110110101000110010101111111
10100001010010000011000110000000011111010100001011
10101111010111111111110011010101111011011111111001
10000000000000000000110110010100000001000000000011
11111111111111111111111111111111111111111111111011